%%%%%%%%%%%%%%%%%%%%%%%%%%%%%%%%%%%%%
%                     %P            %
%                     %             %
%                     %             %
%                     %             %
%                     %             %
%                     %%%%%%%%      %
%                            %      %
%                            %      %
%                            %      %
%                            %      %
%                            %      %
%      %%%%%%%%%%%%%%%%%            %
%      %                            %
%      %                            %
%      %                            %
%      %                            %
%      %%%%                         %
%        .%                         %
%%%%%%%%%%%%%%%%%%%%%%%%%%%%%%%%%%%%%
